###############################
#p     ** *    *   *  * * *   #
# # # #*# # #*#*# # # #*#*#*# #
#  x*     f**  *  1   * 2 * * #
# # # # # #*# # #*#*# # # # #*#
#                             #
# # # # # # # # # #*# #*# # # #
#s  b      *  *      *        #
# # # # #s# # # #*#*# # # # # #
#*    **  *       *           #
# #*# # # # # # #*# # # # # # #
#           *   *  *          #
###############################
