###############################
#p     ** *    *   *  * * *   #
# # # #*# # #*#*# # # #*#*#*# #
#  x*     f**  *  1   * 2 * * #
# # # # # #*# # #*#*# # # # #*#
#          *                  #
# # # # # # #*# # #*# #*# # # #
#s  *      *  *      *        #
# # # # #s#*# # #*#*# # # # # #
#*    **  *       *           #
# #*# # # #*#*# #*# # # # # # #
#           *   *  *          #
###############################
